XPXXXXXXXXXXXXXXXXXXXXXXX
XPXXXXXXXXXXXXXXXXXXXXXXX
XPXXPPPPXXPPPPXXPPPPXXXXX
XPXXPXXPXXPXXPXXPXXPXXXXX
XPXXPXXPXXPXXPXXPXXPXXXXX
XPXXPXXPXXPXXPXXPXXPXXXXX
XPXXPXXPXXPXXPXXPXXPXXXXX
XPXXPXXPXXPXXPXXPXXPXXXXX
XPXXPXXPXXPXXPXXPXXPXXXXX
XPXXPXXPXXPXXPXXPXXPXXXXX
XPXXPXXPXXPXXPXXPXXPXXPPB
XPXXPXXPXXPXXPXXPXXPXXPXX
XPXXPXXPXXPXXPXXPXXPXXPXX
XPXXPXXPXXPXXPXXPXXPXXPXX
XPXXPXXPXXPXXPXXPXXPXXPXX
XPXXPXXPXXPXXPXXPXXPXXPXX
XPXXPXXPXXPXXPXXPXXPXXPXX
XPXXPXXPXXPXXPXXPXXPXXPXX
XPPPPXXPPPPXXPPPPXXPPPPXX
XXXXXXXXXXXXXXXXXXXXXXXXX
